WWWWWWWWWWWWWWWWWWWWWWWWWWWWWWWWWWWWWWWWWWWWWWWWWWW
SPPPPPWPPPWPPPPPWPWPPPPPPPWPPPPPPPPPPPWPWPPPWPPPWPW
WPWWWPWPWPWWWPWPWPWPWWWWWPWPWWWWWWWWWPWPWPWPWPWPWPW
WPPPWPWPWPPPWPWPPPWPPPPPWPPPWPPPPPPPWPPPWPWPWPWPPPW
WPWWWPWPWWWPWPWWWWWWWWWPWWWPWWWWWWWPWWWPWWWPWPWWWWW
WPWPPPWPPPWPWPPPPPWPPPPPWPWPPPPPWPWPPPPPWPPPWPWPPPW
WPWPWWWWWPWPWWWWWPWPWWWPWPWWWWWPWPWWWWWWWPWWWPWPWPW
WPWPPPPPPPWPPPPPWPWPWPPPWPPPPPPPWPPPWPPPWPPPWPPPWPW
WPWWWWWWWWWWWPWWWPWPWPWWWWWWWWWWWPWPWPWWWWWPWWWPWPW
WPPPPPWPPPPPPPPPPPWPWPWPPPWPPPWPPPWPPPPPWPWPWPPPWPW
WWWWWPWWWWWWWPWWWWWPWPWPWPWPWPWPWWWWWWWPWPWPWWWPWPW
WPPPWPPPWPPPWPWPWPPPWPPPWPWPWPPPWPPPPPWPWPWPWPPPWPW
WPWPWWWPWPWPWPWPWPWWWWWWWWWPWWWWWPWWWPWPWPWPWPWWWPW
WPWPPPPPWPWPWPPPPPWPWPPPPPPPPPWPWPWPPPWPPPWPPPWPPPW
WPWWWWWWWPWPWWWWWPWPWPWWWWWWWPWPWPWPWWWWWPWPWWWPWWW
WPPPWPPPPPWPWPPPWPPPWPPPPPWPPPWPWPWPPPPPWPWPPPWPPPW
WWWPWWWWWWWPWPWPWWWWWWWWWPWWWWWPWPWWWWWPWPWWWPWWWPW
WPPPWPPPWPPPPPWPWPPPWPPPWPPPPPPPWPPPWPWPWPPPWPWPPPW
WPWWWPWPWWWPWWWWWPWPWWWPWWWWWWWPWWWPWPWPWWWPWPWPWWW
WPPPPPWPWPPPWPPPWPWPPPWPWPPPPPWPPPWPWPPPWPWPWPWPPPW
WWWPWWWPWPWWWPWPWPWWWPWPWPWWWPWWWPWPWWWWWPWPWPWWWPW
WPWPPPWPPPWPPPWPPPWPPPWPPPPPWPPPWPWPWPPPPPWPPPWPPPW
WPWPWPWWWWWPWWWWWWWPWWWWWWWWWPWWWPWPWPWWWWWWWWWWWWW
WPWPWPWPPPWPPPPPWPPPWPPPWPPPPPWPPPWPWPWPPPWPPPPPPPW
WPWPWPWPWPWWWWWPWPWPWWWPWWWPWWWPWWWPWPWWWPWPWWWWWPW
WPPPWPPPWPPPPPWPWPWPWPPPWPPPWPPPWPPPWPPPWPWPPPWPPPW
WWWWWWWWWPWWWWWPWPWWWPWWWPWWWPWWWPWWWWWPWPWWWPWWWWW
WPPPWPPPWPPPPPWPWPWPPPPPPPWPPPPPPPWPWPPPWPPPWPPPPPW
WPWPWWWPWWWWWPWPWPWPWPWWWWWPWPWWWWWPWPWWWPWPWWWWWPW
WPWPPPWPWPPPWPWPWPPPWPPPPPPPWPWPPPPPPPPPPPWPWPPPWPW
WWWPWPWPWPWWWPWPWWWWWPWWWWWWWPWWWPWWWPWWWWWPWPWWWPW
WPPPWPPPWPPPPPPPWPPPPPWPPPPPWPPPWPPPWPWPPPWPPPPPWPW
WPWWWWWWWWWWWPWWWPWWWWWPWPWWWWWPWWWPWPWPWPWWWWWPWPW
WPPPPPWPPPWPPPWPWPPPPPWPWPPPWPPPWPPPWPWPWPWPPPWPWPW
WWWWWPWPWWWPWPWPWWWWWPWWWWWPWPWPWPWWWPWWWPWPWPWPWPW
WPPPPPPPWPPPWPWPWPWPPPWPPPPPWPWPWPWPWPPPPPWPWPWPWPW
WPWWWPWWWPWWWWWPWPWPWWWPWPWWWWWPWPWPWPWWWWWWWPWPWPW
WPPPWPPPWPWPWPPPPPWPPPWPWPPPPPWPWPPPWPWPPPPPPPPPWPW
WWWWWWWPWPWPWPWPWPWWWPWPWWWWWPWPWPWWWWWPWWWWWWWWWPW
WPPPPPWPPPWPWPWPWPPPWPWPWPPPWPWPPPWPPPWPPPPPWPPPPPW
WPWPWWWPWWWPWPWPWWWPWPWPWPWPWPWPWWWPWPWWWWWPWPWWWPW
WPWPPPWPWPPPWPWPWPPPWPWPWPWPPPWPPPWPWPPPWPPPWPPPWPW
WPWWWPWPWPWPWPWPWWWWWPWPWWWWWWWWWPWWWWWPWPWWWWWPWPW
WPPPWPWPWPWPWPWPPPWPPPWPPPPPWPPPPPPPWPWPWPPPPPWPWPW
WWWPWPWWWPWPWPWWWPWPWWWWWWWPWWWWWPWPWPWPWWWWWPWPWPW
WPPPWPPPPPWPPPWPWPPPWPPPPPWPWPPPPPWPPPWPPPWPWPPPWPW
WPWWWWWWWWWWWWWPWWWPWPWWWPWPWPWPWWWPWWWWWPWPWWWWWPW
WPPPPPPPPPPPWPWPWPPPWPPPWPWPPPWPPPWPWPPPPPWPPPWPPPW
WWWWWWWWWWWPWPWPWPWWWWWPWWWWWWWWWPWPWWWPWWWWWPWPWPW
WPPPPPPPPPPPWPPPPPPPPPWPPPPPPPPPPPWPPPPPPPPPWPPFWPP
WWWWWWWWWWWWWWWWWWWWWWWWWWWWWWWWWWWWWWWWWWWWWWWWWWW