WWWWWWWWWWWWWWWWWWWWWWWWWWWWWWWWWWWWWWWWWWWWWWWWWWW
PPWPPPPPPPPPWPWPPPWPPPPPWPWPPPWPWPPPPPWPWPSPWPWPPPW
WPWPWWWWWWWPWPWPWPWWWWWPWPWPWPWPWPWWWPWPWPWPWPWPWPW
WPWPPPWPPPWPWPPPWPPPPPPPWPPPWPPPWPWPPPWPPPWPWPPPWWW
WPWWWPWPWWWPWWWWWPWWWPWWWWWPWWWWWPWPWWWWWWWPWWWWWPW
WPWPPPWPWPPPWPPPWPWPPPPPPPPPWPPPWPWPPPPPWPPPWPPPPPW
WPWPWWWPWPWWWPWPWPWWWPWWWWWWWWWPWPWWWWWPWPWWWPWWWPW
WPWPPPPPWPWPPPWPWPPPWPPPPPPPPPWPWPWPPPWPPPPPWPPPWPW
WPWWWWWWWPWPWWWPWWWPWWWWWWWWWPWPWPWPWPWWWWWPWPWWWPW
WPWPPPWPPPWPPPWPWPWPWPPPPPWPPPWPWPWPWPPPWPPPWPPPWPW
WPWPWPWPWWWWWWWPWPWPWPWWWPWPWWWPWPWWWPWPWPWWWWWPWPW
WPPPWPWPPPWPPPPPWPPPWPPPWPWPWPPPWPPPWPWPPPWPPPWPWPW
WWWWWPWWWPWPWWWWWWWWWWWPWPWPWPWWWWWPWPWWWWWPWPWPWPW
WPPPWPWPWPWPPPWPPPWPPPPPWPPPWPPPPPPPWPPPPPPPWPWPWPW
WPWPWPWPWPWWWPWPWPWWWPWWWWWWWPWWWWWWWWWWWWWWWPWPWPW
WPWPWPPPWPWPWPWPWPPPWPWPPPPPPPWPPPPPPPPPWPPPWPPPWPW
WPWPWWWPWPWPWPWPWWWPWPWPWWWPWWWPWWWWWWWPWWWPWWWWWPW
WPWPWPPPPPWPPPWPPPWPPPWPWPPPWPPPWPPPWPWPPPWPPPWPPPW
WPWWWPWPWWWPWWWPWPWWWWWPWPWWWPWWWPWPWPWWWPWWWPWPWPW
WPPPPPWPWPPPWPWPWPWPPPPPWPPPPPWPPPWPPPPPPPWPPPWPPPW
WWWWWWWPWPWWWPWPWPWPWWWWWWWWWWWPWWWWWPWWWWWWWPWWWPW
WPPPPPPPWPPPPPWPWPPPWPPPPPPPPPPPWPPPPPWPPPPPPPPPPPW
WPWWWPWWWPWWWWWPWWWWWPWWWWWWWWWPWPWWWWWPWWWWWPWWWPW
WPPPWPWPPPPPPPWPWPPPWPWPPPWPPPWPWPWPWPPPWPPPWPPPWPW
WPWPWPWPWPWPWWWPWPWWWPWPWPWPWPWWWPWPWPWWWPWPWWWPWPW
WPWPWPPPWPWPWPPPWPWPPPPPWPWPWPPPWPWPPPWPPPWPPPPPWPW
WWWPWWWWWPWWWPWWWPWPWWWWWPWPWWWPWPWWWWWWWPWWWWWWWPW
WPPPWPPPWPPPWPPPWPPPWPWPPPWPPPWPPPWPPPPPWPWPPPPPWPW
WPWWWPWPWWWPWPWPWWWWWPWPWWWWWPWWWWWWWPWPWPWPWWWPWPW
WPPPWPWPWPPPWPWPPPPPWPPPWPPPWPPPPPPPPPWPWPPPWPWPPPW
WWWPWWWPWPWWWPWWWWWPWWWWWPWPWWWWWWWWWWWPWWWWWPWWWPW
WPPPWPPPWPPPPPWPPPPPWPPPWPWPPPPPPPWPPPPPWPPPWPPPPPW
WPWWWPWWWWWWWWWPWWWWWPWPWPWWWWWWWWWPWWWWWPWPWWWWWPW
WPPPWPWPPPWPPPWPPPWPWPWPPPWPPPWPPPPPWPPPPPWPPPPPPPW
WWWPWPWWWPWPWPWWWPWPWPWWWPWPWPWWWPWWWPWWWWWPWWWWWPW
WPPPPPWPPPWPWPPPPPWPPPWPWPPPWPPPPPWPPPWPPPPPWPPPWPW
WPWWWPWPWWWPWWWWWWWWWWWPWWWWWWWWWWWWWWWPWWWWWWWPWWW
WPPPWPWPWPWPPPWPPPPPWPPPWPPPPPWPWPPPPPPPWPPPPPWPPPW
WPWPWWWPWPWWWPWWWPWPWPWPWWWWWPWPWPWWWWWWWWWPWPWWWPW
WPWPPPPPWPPPWPPPPPWPPPWPPPWPPPWPWPWPPPPPPPWPWPPPWPW
WWWWWWWWWPWPWWWPWWWPWWWPWPWPWWWPWPWWWWWWWPWPWPWWWPW
WPPPWPPPPPWPPPPPWPPPWPPPWPWPWPPPWPPPPPPPPPWPWPWPPPW
WPWPWPWWWWWWWWWWWPWPWPWWWPWPWPWPWPWPWWWWWWWPWPWPWPW
WPWPPPWPPPWPPPPPPPWPWPWPPPPPWPWPPPWPWPPPWPPPWPPPPPW
WPWWWWWPWPWWWWWWWWWPWPWPWWWWWPWWWWWPWPWPWPWWWWWWWPW
WPPPPPPPWPPPWPWPPPWPWPWPPPWPPPWPPPPPPPWPWPWPPPPPWPW
WWWWWWWWWWWPWPWPWPWWWPWWWPWPWWWPWWWPWWWWWPWPWWWPWPW
WPWPPPPPPPPPWPWPWPPPPPWPWPWPPPWPPPWPWPPPPPWPWPWPPPW
WPWPWWWWWPWWWPWPWWWPWWWPWPWWWPWWWPWPWPWWWWWPWPWWWPW
WPPPWPPPPPWPPPPPWPPPWPPPPPPPPPWPPPWPPPWPPPPPWPPPPPF
WWWWWWWWWWWWWWWWWWWWWWWWWWWWWWWWWWWWWWWWWWWWWWWWWWW