WWWWWWWWWWWWWWWWWWWWWWWWWWWWWWWWWWWWWWWWWWWWWWWWWWWWWWWWWWWWWWWWWWWWWWWWWWWWWWWWWWWWWWWWWWWWWWWWWWWWW
PPPPWPPPPPPPPPWPPPPPPPPPPPPPWPPPWPPPPPPPPPPPPPWPPPWPPPPPWPPPPPPPPPPPPPPPWPPPPPPPWPWPPPWPPPPPWPPPWPPPW
WPWWWPWWWWWWWPWPWWWWWWWWWWWPWPWPWPWWWWWWWWWWWPWPWPWPWWWPWPWWWWWWWWWWWWWPWPWWWWWPWPWPWPWPWPWWWPWPWPWPW
WPWPPPWPPPPPPPWPPPPPWPWPPPPPWPWPWPPPPPWPPPPPPPWPWPPPPPWPWPWPPPPPWPPPPPWPWPPPWPWPWPPPWPWPWPPPWPWPPPWPW
WPWPWWWPWWWWWPWWWWWPWPWPWWWWWWWPWWWWWPWPWWWWWWWPWWWWWWWPWPWPWWWPWPWWWPWPWWWPWPWPWWWPWPWPWWWPWPWWWWWPW
WPPPWPWPWPPPWFWPPPWPWPWPWPPPPPWPPPPPWPWPPPWPPPPPWPPPPPPPWPPPWPPPWPWPPPWPPPWPPPWPPPWPWPPPWPPPWPPPPPWPW
WWWWWPWPWWWPWWWPWWWPWPWPWPWWWPWWWWWPWPWPWPWPWWWWWWWWWWWWWPWWWPWWWWWPWWWWWPWWWWWWWPWWWWWPWPWWWWWWWPWPW
WPWPPPWPPPWPWPPPWPPPWPPPPPWPWPWPPPWPWPWPWPWPPPWPWPPPPPPPWPWPPPWPPPPPPPPPPPWPPPPPPPWPPPPPWPWPPPWPPPWPW
WPWPWWWWWPWPWPWWWPWWWWWPWWWPWPWPWPWPWPWWWPWPWPWPWPWWWWWPWPWPWWWWWWWPWWWWWWWPWPWWWPWPWWWWWPWPWPWPWWWPW
WPPPPPPPWPWPPPWPPPWPPPPPWPWPPPWPWPWPWPWPPPPPWPPPWPWPPPWPWPWPPPWPPPWPPPWPPPPPWPPPWPWPWPWPPPPPWPPPPPWPW
WPWWWWWPWPWPWWWPWWWPWWWWWPWPWWWPWWWPWWWPWPWWWWWWWPWWWPWPWWWWWPWPWPWWWPWPWPWWWWWPWWWPWPWPWWWWWWWWWWWPW
WPWPPPWPWPPPPPWPWPWPWPPPWPPPWPPPWPPPWPPPWPPPWPPPWPPPPPWPPPWPWPPPWPWPPPWPWPPPWPPPWPPPWPPPWPPPPPPPPPWPW
WPWPWPWPWWWWWPWPWPWPWPWPWWWWWPWPWPWWWPWPWWWWWPWPWWWWWWWWWPWPWWWWWPWPWWWWWWWPWPWWWPWWWWWPWPWWWWWWWPWWW
WPWPWPWPPPPPPPWPPPWPPPWPPPPPWPWPPPPPWPWPWPPPPPWPWPPPWPPPPPWPWPPPWPWPWPPPPPWPWPWPPPWPPPPPWPPPWPPPWPPPW
WPWPWPWWWWWWWWWWWPWWWWWWWWWPWWWWWPWPWPWWWPWPWWWPWPWWWPWWWWWPWPWWWPWPWPWWWPWPWPWPWWWPWWWWWWWPWPWPWWWPW
WPPPWPPPPPWPPPPPWPWPPPPPPPPPWPPPPPWPWPPPPPWPWPPPPPPPWPPPPPPPWPWPPPWPWPPPWPPPWPWPWPWPPPWPPPPPWPWPPPPPW
WWWPWWWWWPWPWWWPWPWWWWWWWWWWWPWWWWWPWWWWWWWPWPWPWWWPWPWPWWWWWPWPWWWPWPWPWWWWWPWPWPWWWPWPWWWWWPWWWWWWW
WPPPPPPPWPWPWPPPWPWPPPWPPPWPPPWPPPWPWPPPWPPPWPWPPPWPPPWPWPWPPPPPWPPPWPWPWPPPPPWPPPWPPPWPPPPPWPWPPPPPW
WPWWWWWPWPWPWPWWWPWPWPWWWPWPWWWWWPWPWPWPWWWWWPWWWPWWWWWPWPWPWPWWWPWWWWWPWPWWWWWWWPWPWWWWWWWWWPWPWWWPW
WPWPPPWPWPPPWPPPWPWPWPPPWPPPPPPPWPPPWPWPPPPPWPWPPPWPPPWPPPWPWPWPWPWPPPWPWPPPWPPPPPWPPPPPPPPPPPWPPPWPW
WPWPWPWWWWWWWWWPWPWPWWWPWWWWWWWPWWWWWPWWWPWPWPWPWWWWWPWWWWWPWPWPWPWPWPWPWWWWWPWWWWWWWWWWWWWWWWWWWPWWW
WPWPWPPPWPPPPPPPPPWPWPPPPPPPWPWPWPPPWPPPWPWPWPWPWPPPWPPPPPWPWPPPWPPPWPPPWPPPWPPPWPPPPPWPPPWPPPPPWPPPW
WPWWWWWPWWWWWWWWWPWPWWWPWWWPWPWPWPWWWWWWWPWWWPWPWPWPWPWPWPWPWWWWWWWWWWWWWPWPWWWPWPWWWPWPWPWPWWWPWWWPW
WPPPPPPPWPPPPPPPWPWPPPWPWPPPWPWPWPPPPPWPPPWPPPWPPPWPPPWPWPWPPPWPPPWPPPPPPPWPWPWPWPWPPPWPWPWPPPWPWPWPW
WWWPWPWWWPWWWPWPWWWWWPWWWPWWWPWPWWWWWPWPWWWPWWWWWWWPWWWWWPWWWPWPWPWWWPWWWWWPWPWPWPWPWWWPWPWWWPWPWPWPW
WPPPWPPPWPWPPPWPPPPPWPPPWPPPPPWPPPWPPPWPPPWPPPWPPPPPWPPPWPPPWPWPWPWPPPWPWPPPPPPPWPWPWPPPWPPPPPWPWPPPW
WPWWWWWWWPWPWWWWWWWPWWWPWWWPWWWWWPWPWWWPWWWWWPWPWWWWWPWPWWWPWPWPWPWPWWWPWPWWWWWWWPWPWWWPWWWWWPWPWWWPW
WPPPWPPPPPWPWPPPPPWPPPWPWPPPWPPPPPWPPPPPPPWPPPWPWPPPWPWPWPPPWPPPWPWPPPPPWPPPWPPPWPWPPPPPPPWPPPWPPPPPW
WWWPWPWWWWWWWPWWWPWWWPWPWPWWWPWWWWWWWPWPWPWWWPWPWPWPWPWPWPWWWPWWWPWWWWWWWWWPWPWPWPWWWWWWWWWPWWWWWWWWW
WPWPWPPPPPPPPPWPWPWPWPPPWPWPPPPPPPWPPPWPWPWPPPWPPPWPWPWPWPPPPPWPPPWPPPWPPPWPWPWPPPWPPPWPPPPPWPPPPPWPW
WPWPWWWPWWWWWWWPWPWPWWWWWPWWWPWWWPWWWWWPWPWPWWWWWPWPWWWPWWWWWWWPWWWPWPWPWPWPWPWWWWWWWPWPWWWWWPWWWPWPW
WPWPWPPPWPPPPPWPPPWPWPPPWPPPPPWPPPWPPPWPWPWPWPPPWPWPPPPPWPPPPPWPPPWPWPPPWPWPPPPPWPPPWPPPWPWPPPPPWPWPW
WPWPWWWPWPWWWPWWWWWPWWWPWWWWWWWPWWWPWPWWWPWPWPWPWPWWWWWWWPWPWWWWWPWPWWWPWWWWWPWPWPWPWWWWWPWPWPWWWPWPW
WPPPPPPPWPPPWPPPPPWPPPWPPPPPPPWPPPWPWPWPPPWPWPWPWPWPPPPPPPWPWPPPPPWPWPWPPPPPPPWPWPWPWPWPPPPPWPPPWPPPW
WWWPWWWWWWWPWWWWWPWWWPWWWWWWWPWWWPWWWPWPWWWPWPWPWWWPWWWWWWWPWPWPWWWPWPWWWWWWWWWPWWWPWPWPWWWWWWWPWWWWW
WPPPWPPPPPPPWPPPWPPPWPPPPPPPWPPPWPWPPPWPWPPPWPWPPPWPPPPPWPPPWPWPWPPPWPPPWPPPWPPPPPWPPPWPWPWPPPPPWPPPW
WPWWWPWWWWWWWPWPWWWPWWWPWWWPWWWPWPWPWWWPWPWWWPWWWPWWWWWPWWWWWWWPWPWWWWWPWPWPWPWWWPWPWWWPWPWPWWWWWPWPW
WPPPWPWPWPPPPPWPWPWPPPWPPPWPWPPPWPWPPPWPWPPPWPWPWPPPPPWPPPPPWPPPWPWPPPWPPPWPWPWPPPWPPPWPPPWPWPWPPPWPW
WWWPWPWPWPWWWWWPWPWWWPWPWWWPWPWWWPWWWPWPWWWPWPWPWWWWWPWWWWWPWPWWWWWPWPWWWWWPWPWPWWWWWPWWWWWPWPWPWWWPW
WPPPWPWPPPPPWPPPWPWPPPPPWPPPWPPPPPWPWPWPPPWPWPPPWPPPPPPPWPPPWPWPPPWPWPWPPPWPWPWPWPPPWPPPPPWPPPWPWPPPW
WPWWWPWWWPWWWPWWWPWWWWWWWPWPWWWPWWWPWPWWWPWPWWWWWWWWWPWPWPWPWPWPWPWPWPWPWWWPWPWPWPWPWPWWWPWWWPWPWWWWW
WPPPWPPPPPWPPPWPPPPPPPPPPPWPWPPPPPPPPPPPPPWPWPPPPPWPWPWPWPWPWPPPWPPPWPWPPPWPWPWPWPWPPPWPPPWPPPWPWPPPW
WWWPWWWWWWWPWWWPWWWWWWWWWWWWWPWWWWWPWWWWWWWPWPWWWPWPWPWPWPWPWWWWWWWWWPWWWPWPWPWPWPWWWWWPWWWPWWWPWPWPW
WPWPWPPPPPWPPPWPPPPPWPPPPPWPPPWPWPPPWPPPWPPPWPWPPPPPWPWPWPWPPPWPPPWPPPPPWPPPPPWPPPPPPPWPPPPPWPPPWPWPW
WPWPWPWWWPWWWPWWWWWWWPWPWWWPWWWPWPWWWPWPWWWPWPWPWPWWWPWPWPWWWPWWWPWWWWWPWPWPWWWWWWWWWPWWWWWWWPWWWPWPW
WPPPWPWPWPPPWPPPPPWPPPWPPPPPWPWPPPPPPPWPPPPPPPWPWPPPWPWPWPWPPPWPPPWPPPPPWPWPPPWPPPPPPPWPPPWPPPWPPPWPW
WPWWWPWPWWWPWWWWWPWPWWWWWWWWWPWWWPWWWWWWWWWPWWWWWWWPWPWPWPWPWWWPWWWPWPWWWWWWWPWPWWWWWWWPWWWPWWWPWWWWW
WPPPPPWPPPWPPPWPWPPPWPPPPPWPPPPPPPWPPPPPPPPPWPPPPPPPWPWPPPWPWPPPWPPPWPPPPPPPPPWPWPPPWPWPWPPPPPWPPPPPW
WWWWWWWWWPWPWPWPWWWWWPWWWWWPWWWWWWWPWWWPWWWWWPWWWWWWWPWWWWWPWPWWWPWWWWWWWWWWWWWPWPWPWPWPWPWPWPWWWWWPW
WPPPWPPPPPPPWPWPPPWPPPPPPPWPPPWPPPPPWPPPWPPPPPWPPPWPPPWPPPPPWPPPWPWPPPPPPPWPPPPPWPWPPPWPPPWPWPWPPPPPW
WPWPWWWPWPWWWPWWWPWPWPWWWPWWWPWPWWWWWPWWWPWWWWWWWPWPWWWPWWWWWWWPWWWPWWWWWPWPWWWWWPWPWWWWWWWPWPWPWPWWW
WPWPPPWPWPPPWPPPPPWPWPPPWPPPPPWPWPPPPPPPWPPPWPWPPPWPWPPPWPPPPPWPPPWPWPWPPPWPWPPPWPWPWPPPWPPPWPWPWPWPW
WWWWWPWWWPWPWWWWWWWWWPWWWWWWWWWPWWWWWWWPWWWPWPWPWPWPWPWWWWWWWPWWWPWPWPWPWWWPWWWPWPWPWPWPWWWPWPWWWPWPW
WPPPPPWPPPWPWPPPWPPPPPWPPPWPPPPPPPPPPPWPPPWPWPWPWPWPWPWPPPPPPPWPPPWPPPWPWPWPWPPPPPWPPPWPPPPPWPPPWPPPW
WPWWWWWPWWWWWPWPWPWWWWWPWPWPWWWWWWWWWWWWWPWPWPWPWPWPWPWPWWWWWWWPWWWWWPWPWPWPWPWWWWWWWWWPWWWWWWWPWWWPW
WPPPPPWPWPPPWPWPWPPPWPPPWPWPWPWPPPPPPPPPPPWPPPPPWPPPWPWPPPPPWPPPWPPPPPWPPPWPWPPPWPPPPPWPPPPPPPWPWPPPW
WWWPWPWPWPWPWPWWWWWPWPWWWPWPWPWPWWWWWWWWWWWPWPWWWWWWWPWWWPWPWWWPWPWWWPWWWWWPWWWPWPWWWPWWWWWWWWWPWPWWW
WPPPWPPPWPWPWPPPPPPPWPWPPPWPWPPPPPWPPPPPPPPPWPPPWPPPWPWPWPWPPPWPWPPPWPWPPPWPPPPPWPPPWPPPPPPPPPPPWPPPW
WPWPWWWWWPWPWWWWWWWWWWWPWWWPWWWWWWWPWWWWWWWWWWWPWPWPWPWPWPWPWPWPWWWPWWWPWPWWWWWWWWWPWPWWWWWWWWWWWWWPW
WPWPPPWPPPWPWPPPPPWPPPPPPPPPWPPPPPPPWPPPPPWPPPPPWPWPWPWPPPWPWPPPWPPPPPPPWPPPPPPPPPPPWPPPPPPPWPPPPPPPW
WPWWWPWWWWWPWWWWWPWWWWWPWWWWWWWWWWWWWPWWWPWPWPWWWPWPWPWWWWWPWWWPWPWPWWWWWWWWWWWWWWWWWWWWWWWPWPWWWWWWW
WPWPWPPPPPPPWPPPWPPPPPWPPPPPWPPPPPPPPPWPPPPPWPPPWPWPWPPPWPPPPPWPWPWPPPWPPPWPPPPPPPWPPPPPWPPPWPPPPPPPW
WPWPWWWWWPWWWPWPWWWWWPWWWWWPWPWWWWWWWWWPWPWWWWWWWPWWWPWPWWWWWPWWWPWWWPWPWPWPWWWWWPWPWWWPWWWPWWWWWWWPW
WPWPPPPPPPPPWPWPPPWPWPWPPPPPWPPPWPPPWPPPWPPPPPPPWPPPWPWPPPPPWPPPWPPPWPPPWPWPWPWPPPWPPPWPPPWPWPPPWPPPW
WPWWWWWWWWWWWPWWWPWPWPWPWWWWWWWPWWWPWPWWWWWWWWWPWWWPWPWWWWWWWWWPWWWPWWWWWPWPWPWPWPWWWPWWWPWPWPWPWPWPW
WPWPPPWPPPWPPPWPWPWPWPPPWPPPPPWPPPPPWPWPPPWPPPWPPPWPPPWPPPPPPPPPWPPPWPPPWPPPWPPPWPWPPPWPPPWPPPWPWPWPW
WPWPWPWPWPWPWWWPWPWPWPWWWPWWWWWWWWWWWPWPWPWPWPWWWPWWWWWPWWWWWWWWWWWWWWWPWWWWWWWWWPWPWWWPWWWWWWWPWWWPW
WPWPWPWPWPWPPPPPWPWPWPPPWPWPPPPPPPPPWPWPWPPPWPPPPPWPPPPPPPPPWPPPPPPPPPWPPPWPPPWPWPPPWPPPWPWPPPPPWPPPW
WPWPWWWPWPWWWWWWWPWPWWWWWPWWWPWWWWWPWPWPWWWWWWWPWWWPWWWWWWWPWPWWWWWWWPWWWPWPWPWPWWWWWPWWWPWPWWWWWPWPW
WPWPPPWPWPWPPPWPPPWPWPPPPPPPPPWPPPWPWPWPPPPPPPWPPPWPPPPPWPPPWPWPPPWPPPWPPPWPWPWPPPPPWPPPPPWPPPPPWPWPW
WPWPWPWPWPWWWPWPWWWPWPWWWWWWWWWPWPWPWPWWWWWWWPWWWPWWWPWPWWWWWPWPWPWPWWWPWWWPWPWPWWWPWPWWWWWWWWWPWPWWW
WPPPWPPPWPPPWPWPWPPPWPWPPPPPWPWPWPWPPPWPPPPPWPPPWPPPWPWPPPPPWPPPWPWPPPWPWPPPWPWPPPWPWPWPPPWPPPWPWPPPW
WWWWWWWWWWWPWPWPWPWWWPWPWWWPWPWPWWWWWWWPWWWPWWWPWWWWWPWWWWWPWWWWWWWPWPWPWPWWWPWWWPWPWPWPWPWPWWWPWWWPW
WPPPPPPPWPPPPPWPWPWPPPWPWPPPWPPPPPPPPPWPWPPPWPPPWPPPWPWPPPPPWPPPWPPPWPPPWPWPPPPPWPWPWPPPWPWPWPPPWPPPW
WPWWWWWPWPWPWWWPWPWPWWWPWPWWWPWWWWWPWWWPWPWWWPWWWPWPWPWPWPWWWWWPWPWWWWWWWPWWWWWWWPWPWWWWWPWPWPWWWPWWW
WPWPWPPPWPWPPPPPPPWPPPWPWPPPWPWPPPWPPPPPWPWPPPWPPPWPPPWPWPWPPPWPPPWPPPPPWPPPWPPPWPWPPPWPPPWPPPWPPPWPW
WPWPWPWWWWWWWWWPWWWWWPWPWPWPWWWPWPWWWWWWWPWPWPWPWWWWWWWPWPWPWPWWWPWPWWWPWWWPWPWPWPWWWWWPWWWPWWWPWWWPW
WPWPWPPPPPPPPPWPPPPPWPPPWPWPPPPPWPPPPPPPPPWPWPPPWPPPPPPPWPPPWPPPPPWPWPWPWPWPPPWPPPWPPPPPWPPPWPPPWPPPW
WPWPWWWWWWWWWPWWWWWPWWWWWWWWWWWWWWWWWWWWWWWPWWWWWPWWWWWWWPWWWWWWWWWPWPWPWPWWWPWWWWWWWPWWWPWWWPWWWPWWW
WPPPPPPPPPWPWPPPPPWPWPPPPPPPPPPPPPPPWPPPWPWPWPPPWPPPWPPPPPWPPPPPPPWPPPWPPPPPWPPPPPPPPPWPWPPPPPWPPPPPW
WWWPWWWPWPWPWWWWWPWPWPWWWWWWWWWWWWWPWWWPWPWPWWWPWWWPWWWWWPWPWWWWWPWPWWWWWWWPWWWWWWWPWWWPWWWWWWWPWWWPW
WPPPPPWPWPPPWPPPWPPPWPWPPPWPPPPPPPWPWPPPWPWPPPWPPPPPWPPPPPPPPPPPWPWPPPWPPPWPPPPPPPPPPPPPWPPPPPPPWPPPW
WPWWWPWWWWWWWPWPWWWWWWWPWPWPWWWWWPWPWPWWWPWWWPWWWWWWWPWWWWWWWWWPWPWWWPWPWPWWWWWWWWWPWWWWWPWWWPWWWPWWW
WPPPWPPPPPPPPPWPPPPPWPPPWPPPWPPPPPWPPPPPPPPPWPWPPPPPWPPPPPWPPPWPWPPPWPWPWPPPWPPPPPPPWPPPPPWPPPWPWPWPW
WWWPWWWWWWWWWWWWWWWPWPWWWPWWWWWWWWWWWPWWWWWWWPWPWWWPWWWWWPWPWPWWWPWPWPWPWWWWWPWPWWWWWPWWWWWWWWWPWPWPW
WPPPPPWPPPPPPPWPWPPPWPWPWPPPPPWPPPPPPPPPWPPPPPWPWPWPPPPPPPWPWPPPPPWPWPWPPPPPWPWPPPWPPPWPPPPPPPPPWPWPW
WWWWWWWPWWWWWPWPWPWWWPWPWWWWWPWPWWWWWPWPWPWWWWWPWPWWWWWWWWWPWPWWWWWPWPWWWWWPWPWWWPWPWWWPWWWWWPWPWPWPW
WPPPPPPPPPPPWPWPWPWPWPWPWPPPWPPPWPPPPPWPPPWPPPWPPPPPPPWPPPPPWPWPPPPPWPWPPPWPPPPPWPPPWPPPPPWPPPWPWPPPW
WPWWWWWWWWWWWPWPWPWPWPWPWPWPWWWPWPWWWWWWWWWPWPWWWPWWWWWPWWWWWPWPWWWWWPWWWPWWWWWWWWWWWPWWWWWPWWWWWWWWW
WPWPPPWPPPPPWPPPWPWPWPPPWPWPPPWPWPPPPPWPPPWPWPWPPPWPPPPPWPPPPPWPWPPPWPPPPPWPWPPPPPPPPPWPWPPPWPPPWPPPW
WPWPWPWWWWWPWWWPWPWPWWWWWPWWWPWWWWWPWPWPWWWPWPWPWWWPWWWWWPWWWWWPWPWPWWWWWWWPWPWWWPWWWWWPWPWWWWWPWWWPW
WPPPWPPPPPWPPPWPWPWPWPPPPPWPWPPPPPWPWPPPWPPPWPPPWPPPWPPPWPWPWPPPWPWPPPWPPPWPWPWPPPWPPPPPPPPPPPPPWPPPW
WWWWWWWPWWWWWPWPWPWPWPWWWWWPWWWPWPWPWWWWWPWWWWWWWPWWWWWPWPWPWPWWWWWWWPWWWPWPWPWWWWWWWPWWWWWWWWWWWPWPW
WPPPPPWPPPPPPPWPPPWPPPWPPPPPWPPPWPPPWPPPPPPPWPPPWPPPWPPPWPWPPPWPPPPPWPPPPPPPWPPPWPWPPPWPPPWPPPPPPPWPW
WPWWWPWWWWWPWWWWWWWWWWWWWPWWWWWWWWWWWPWWWWWWWPWPWWWPWPWWWPWWWWWPWWWPWPWWWPWWWPWPWPWPWPWPWPWWWPWWWWWWW
WPWPWPPPPPWPWPPPPPPPPPPPPPWPPPWPWPPPPPWPWPPPPPWPPPPPPPWPPPPPWPWPWPWPPPWPPPPPWPWPWPPPWPWPWPWPPPWPPPPPW
WPWPWWWWWPWPWPWWWWWWWWWWWWWPWPWPWPWWWWWPWPWWWWWWWWWWWWWPWWWPWPWPWPWWWWWPWWWWWPWPWWWWWPWPWPWPWPWPWWWPW
WPPPWPPPPPPPWPPPPPWPPPPPWPPPWPWPPPWPPPPPWPWPWPPPWPPPPPWPWPPPPPWPWPWPPPPPWPPPWPWPWPPPWPPPWPWPWPPPWPPPW
WWWWWPWWWPWWWWWWWPWPWPWWWPWWWPWPWWWPWPWWWPWPWPWPWPWPWWWPWPWWWWWPWPWPWWWWWPWPWWWPWPWWWWWPWPWPWWWWWPWWW
WPPPPPWPPPWPPPPPPPPPWPPPPPWPPPPPWPPPWPPPPPWPPPWPPPWPPPPPWPPPPPPPPPWPPPPPPPWPPPPPWPPPPPPPWPPPWPPPPPSPP
WWWWWWWWWWWWWWWWWWWWWWWWWWWWWWWWWWWWWWWWWWWWWWWWWWWWWWWWWWWWWWWWWWWWWWWWWWWWWWWWWWWWWWWWWWWWWWWWWWWWW