WWWWWWWWWWWWWWWWWWWWWWWWWWWWWWWWWWWWWWWWWWWWWWWWWWWWWWWWWWWWWWWWWWWWWWWWWWWWWWWWWWWWWWWWWWWWWWWWWWWWWWWWWWWWWWWWWWWWWWWWWWWWWWWWWWWWWWWWWWWWWWWWWWWWWWW
PPWPPPWPPPWPPPWPPPWPPPWPPPPPWPPPWPPPPPWPSPWPWPPPWPPPWPPPPPPPWPPPWPPPPPPPPPPPPPWPPPPPPPWPPPWPPPPPPPWPPPWPPPWPPPWPPPPPWPPPPPWPPPPPPPPPPPPPWPPPPPWPPPWPPPW
WPWPWPWPWPWPWPWPWPWPWPWPWWWPWPWPWPWWWPWPWPWPWPWPWPWPWPWWWWWPWWWPWPWWWPWWWWWWWPWPWWWPWWWPWPWPWPWPWWWPWPWPWPWPWPWPWWWPWPWWWPWPWWWWWWWWWPWPWPWWWPWPWPWWWPW
WPWPWPWPWPWPWPPPWPWPWPWPPPWPWPWPPPWPWPPPWPWPPPWPPPWPPPWPPPWPPPWPWPWPWPPPWPWPPPWPPPWPPPPPWPWPWPWPPPPPWPWPWPWPWPPPWPWPWPPPWPPPWPPPPPPPPPWPPPWPPPWPWPWPPPW
WPWPWPWPWPWWWWWWWPWPWPWWWPWPWPWWWWWPWWWWWPWWWWWPWWWWWWWWWPWWWPWPWPWPWWWPWPWPWWWWWWWPWWWWWPWPWWWWWWWWWPWPWPWPWWWWWPWPWWWPWWWWWWWWWWWPWWWWWWWPWWWWWPWPWWW
WPPPWPPPWPWPPPPPPPPPWPPPWPWPPPWPWPPPPPWPPPPPPPWPWPPPWPPPWPPPWPPPWPPPPPWPWPWPWPPPWPPPWPPPWPPPWPPPPPPPWPWPWPWPPPPPPPWPWPPPPPWPPPPPPPPPWPPPPPPPWPPPPPPPPPW
WWWWWWWWWPWPWWWWWWWWWWWPWPWWWWWPWPWWWPWWWWWWWPWPWPWWWPWPWWWPWWWWWWWWWWWPWPWPWPWPWPWWWPWPWWWWWPWWWWWPWPWPWPWWWWWWWWWPWWWWWPWPWWWWWWWWWPWWWWWWWPWWWPWWWPW
WPPPPPPPPPWPPPWPPPWPPPWPWPWPPPPPWPPPWPPPPPPPPPWPPPWPPPWPPPWPWPPPPPPPPPPPWPWPWPWPWPWPPPWPPPPPWPWPPPWPPPWPWPWPPPWPPPPPWPPPPPWPPPPPPPPPWPWPPPPPWPWPPPWPPPW
WPWWWWWPWWWWWPWWWPWPWPWPWPWPWWWWWWWPWWWWWWWWWWWWWPWPWWWWWPWPWWWPWWWWWWWWWPWPWPWPWPWPWWWWWWWPWPWPWPWWWWWPWPWPWPWPWWWWWPWWWWWWWWWWWWWPWPWPWWWPWPWWWWWPWWW
WPPPPPWPWPPPWPPPPPWPWPPPWPWPWPPPPPPPPPPPWPPPWPPPPPWPWPWPPPWPWPPPWPPPPPPPWPPPWPWPPPWPPPWPPPPPWPWPWPWPPPWPWPPPWPPPWPPPPPWPPPPPPPPPPPPPWPPPWPPPWPPPWPPPWPW
WWWPWWWPWPWPWPWWWWWPWWWWWPWPWPWWWWWPWWWPWPWPWPWWWWWPWPWPWWWPWPWWWPWWWWWPWWWWWPWWWWWWWPWWWWWWWPWPWPWPWPWPWWWWWWWWWPWWWWWPWPWWWWWWWWWWWPWWWPWWWPWPWPWWWPW
WPWPPPWPPPWPWPWPWPPPWPPPPPWPWPWPPPPPWPWPPPWPPPPPPPWPPPWPPPPPWPPPWPWPPPWPPPPPPPPPPPPPWPPPWPWPPPWPWPWPWPWPWPPPWPPPWPPPWPWPWPWPWPPPWPWPPPWPPPWPPPWPWPWPPPW
WPWWWPWWWPWPWPWPWPWWWPWWWWWPWWWPWWWWWPWPWWWWWWWWWWWWWPWWWPWWWWWPWPWPWPWWWWWWWWWPWWWPWWWPWPWPWPWPWPWWWPWPWPWPWWWPWWWPWPWPWPWPWPWPWPWPWWWWWPWPWWWPWPWPWPW
WPWPWPWPPPWPPPWPPPWPPPWPPPWPWPPPWPPPPPWPWPPPPPWPPPWPWPWPWPWPPPWPWPPPWPWPPPPPPPWPPPWPWPPPPPWPWPWPWPPPPPWPPPWPPPWPWPWPWPPPWPPPWPWPPPWPPPWPPPPPWPWPWPWPWPW
WPWPWPWPWWWWWWWWWWWPWWWPWPWPWPWWWPWWWWWPWPWWWPWPWPWPWPWPWPWPWPWPWWWWWPWPWWWWWPWWWPWPWPWWWWWPWPWPWWWWWWWWWWWWWPWPWPWPWWWWWWWWWPWWWWWWWPWPWWWWWPWPWPWPWPW
WPPPPPWPPPWPPPPPPPWPPPWPWPPPWPPPPPWPPPPPWPWPPPWPWPWPWPWPPPWPWPWPWPPPPPWPWPPPWPPPWPWPPPWPWPPPWPWPPPWPPPPPWPPPWPWPWPWPPPWPPPWPPPPPPPPPPPWPWPPPWPPPWPPPWPW
WWWWWWWWWPWPWWWWWPWWWPWPWWWWWWWWWWWWWWWWWPWWWWWPWPWPWPWWWWWPWPWPWPWWWWWPWPWPWWWPWPWWWWWPWPWWWWWWWPWPWWWPWPWPWPWPWPWWWPWWWPWPWWWWWWWPWWWPWPWWWWWWWWWWWPW
WPPPPPPPWPWPWPPPPPWPPPPPWPPPPPPPPPPPWPPPPPPPWPPPWPWPPPWPPPPPWPWPWPPPPPPPWPWPPPPPWPWPPPWPWPPPWPPPPPWPPPWPPPWPWPWPPPWPPPWPPPWPWPPPWPWPPPWPWPPPWPPPPPWPPPW
WPWWWWWPWPWPWPWWWWWWWPWWWPWWWWWWWWWPWPWWWWWPWPWWWPWWWPWWWWWPWPWPWWWWWWWWWWWWWWWPWPWWWPWPWPWPWPWWWWWWWWWWWWWPWPWWWPWPWWWPWWWWWPWPWPWWWWWPWWWPWWWWWPWPWWW
WPPPPPWPWPWPWPPPPPWPPPWPPPWPPPWPPPWPWPPPWPWPWPWPWPPPWPPPWPPPWPWPPPPPWPPPPPWPPPWPWPPPPPWPPPWPWPPPPPWPPPWPPPPPWPWPPPWPPPPPPPPPPPWPWPWPPPPPWPWPWPPPPPWPPPW
WWWWWPWPWPWPWWWPWPWPWWWWWWWWWPWPWPWPWWWPWPWPWPWPWWWPWWWPWPWPWWWWWWWPWPWWWPWPWWWPWWWWWPWWWWWPWPWWWPWPWPWPWWWWWPWPWWWWWPWWWWWWWWWPWPWPWPWWWPWPWPWWWWWWWPW
WPPPPPWPWPWPWPPPWPWPWPPPWPPPWPWPWPPPWPPPWPPPWPWPPPPPWPPPWPWPWPPPPPPPWPPPWPWPPPPPWPPPPPWPPPWPWPPPWPPPWPPPWPWPPPWPPPWPWPWPPPWPPPWPPPWPWPPPPPPPWPWPPPPPPPW
WPWWWWWWWPWPWWWWWWWPWWWPWPWPWPWPWWWWWPWPWWWWWPWWWWWWWPWWWPWPWPWWWWWWWWWPWPWWWWWWWPWWWPWPWWWPWWWPWWWWWWWWWPWPWWWWWPWPWPWWWPWPWPWPWWWPWWWWWPWWWPWWWWWPWWW
WPPPPPWPPPWPPPPPWPPPPPWPWPWPWPPPWPPPWPWPPPPPWPPPWPPPPPWPPPWPWPWPPPPPPPPPWPPPPPPPWPWPPPWPWPPPWPPPWPPPPPPPWPWPWPWPPPWPWPPPWPWPWPWPWPPPWPPPWPPPWPPPPPWPPPW
WWWPWPWPWWWWWPWWWPWPWPWPWPWPWPWWWWWPWPWWWWWWWWWPWPWWWWWPWWWPWPWPWWWWWWWWWWWWWWWPWPWPWWWPWPWWWPWPWPWWWWWPWPWPWPWPWWWPWWWPWPWWWPWPWWWWWPWWWWWPWPWWWPWWWWW
WPPPWPPPWPPPPPWPPPWPWPWPWPWPWPWPPPPPWPPPWPPPPPPPWPPPPPWPPPWPWPWPPPWPPPWPPPWPPPPPWPWPWPWPWPPPWPWPWPWPPPWPPPWPPPPPPPWPWPWPWPWPPPWPWPPPPPPPPPPPWPPPWPPPPPW
WPWWWWWWWPWPWWWPWWWPWPWPWPWPWPWPWWWWWWWPWPWWWWWWWWWWWPWWWPWPWPWWWPWPWPWPWPWWWWWPWWWPWPWPWWWPWWWPWPWPWWWWWWWWWWWPWPWPWPWPWPWPWPWWWPWWWWWWWWWWWWWWWPWWWPW
WPPPPPPPPPWPPPWPWPPPWPPPWPWPWPPPPPWPPPPPWPWPPPPPWPPPPPWPWPWPPPWPPPWPWPWPWPWPPPPPPPWPWPWPPPPPWPPPPPWPPPPPWPPPPPPPWPPPPPWPPPWPWPPPWPPPPPWPPPPPWPPPPPPPWPW
WPWWWWWWWWWWWPWPWPWWWWWWWPWPWPWWWPWPWWWWWPWPWWWPWWWPWWWPWPWWWWWPWWWPWPWWWPWPWWWPWPWPWPWWWWWWWPWWWWWWWWWPWPWWWWWWWWWPWWWPWWWPWWWPWWWWWPWPWWWPWPWWWWWWWPW
WPPPWPPPPPWPWPPPWPPPPPPPPPWPPPWPPPWPWPPPPPWPWPWPPPWPWPPPWPWPPPPPWPPPWPPPPPWPWPPPWPWPWPWPPPWPPPPPWPPPWPWPPPPPWPPPPPPPWPWPWPPPWPPPPPPPWPPPWPPPWPWPWPPPPPW
WWWPWPWWWPWPWWWWWWWWWPWWWWWPWWWPWWWPWWWPWWWPWPWWWPWPWPWWWPWPWWWWWPWWWWWWWPWWWPWWWPWPWPWPWPWPWWWPWWWPWPWWWWWPWWWWWPWWWPWPWWWWWWWWWWWPWWWWWPWWWPWPWPWWWPW
WPPPWPPPWPWPWPPPPPPPPPWPWPPPWPPPPPWPPPWPWPWPPPWPWPWPPPPPPPWPWPPPPPWPPPPPWPPPPPWPWPPPWPWPWPWPWPPPPPPPWPPPPPPPWPPPPPWPPPPPPPPPWPPPPPWPPPWPPPWPPPWPPPWPWPW
WPWWWWWPWPWPWPWWWWWWWWWPWPWPWPWWWPWWWPWPWPWWWWWPWPWWWPWWWWWPWPWWWWWPWPWWWWWWWWWPWWWWWPWPWPWPWPWWWPWWWWWWWPWWWPWWWWWPWWWWWWWPWPWWWPWWWPWPWWWPWWWWWWWPWPW
WPWPPPWPWPPPWPWPPPPPWPPPPPWPWPPPWPWPPPPPWPPPWPPPPPPPWPPPWPPPWPPPPPPPWPPPPPPPWPPPWPPPWPWPWPWPWPWPWPWPPPPPPPWPPPWPPPPPWPWPPPPPWPPPWPWPPPWPPPPPWPWPPPWPPPW
WPWWWPWPWWWWWPWPWWWWWPWPWWWWWWWPWPWPWPWPWWWPWPWWWPWWWWWPWPWPWWWPWWWWWWWWWWWPWPWPWPWPWPWWWPWPWPWPWPWWWWWWWWWWWPWPWWWWWPWPWWWWWWWPWPWPWWWWWWWWWPWPWPWWWPW
WPPPPPWPWPPPPPWPPPPPPPWPPPPPWPPPWPWPWPWPPPPPWPWPPPPPWPPPWPWPWPPPWPPPPPPPPPWPPPWPWPWPPPWPPPWPWPPPWPWPPPWPPPPPPPWPWPPPPPWPPPPPWPPPWPWPWPPPWPPPWPPPWPPPWPW
WWWWWWWPWPWWWWWWWWWWWWWWWWWPWPWWWWWPWPWWWWWWWWWPWWWPWPWPWPWPWWWWWPWWWWWWWWWWWWWPWPWWWWWPWWWPWWWWWPWPWPWPWWWWWWWPWPWWWWWPWWWPWPWWWPWPWWWPWPWWWWWWWWWPWPW
WPPPPPWPWPPPWPWPPPPPWPPPPPPPWPPPPPWPWPPPWPPPWPPPWPPPWPWPWPWPWPPPPPPPPPPPPPPPPPPPWPWPPPWPPPWPWPPPWPPPWPWPWPWPPPWPWPPPPPWPPPWPWPPPWPWPPPWPWPPPPPPPWPWPPPW
WPWWWWWPWWWPWPWPWWWPWPWWWWWWWWWWWPWPWWWPWPWPWPWWWPWWWWWPWPWWWPWWWWWWWWWWWWWWWWWWWPWWWPWWWPWPWPWWWWWPWPWPWPWPWPWPWWWPWPWWWWWPWWWPWWWPWPWPWWWWWWWPWPWWWPW
WPPPPPWPPPPPWPWPWPWPWPWPPPPPPPWPWPWPPPWPPPWPWPWPPPWPPPPPWPPPWPWPPPWPPPWPPPPPWPPPWPPPWPPPPPWPPPWPPPPPWPWPPPPPWPPPPPWPWPWPPPPPWPPPPPWPWPWPPPWPPPWPWPWPPPW
WWWWWPWWWWWWWPWPWPWPWPWPWWWWWPWPWPWWWPWPWPWWWPWPWWWPWPWWWPWPWPWPWWWPWPWPWWWPWWWPWWWPWPWWWWWWWWWPWWWWWWWWWWWWWWWPWPWPWPWPWWWWWPWPWPWWWPWWWPWPWPWPWPWWWWW
WPPPWPPPWPPPPPPPWPPPPPWPWPPPWPWPWPPPPPWPWPWPPPWPPPWPWPPPWPWPWPWPPPPPWPWPPPWPPPPPWPWPPPPPPPWPPPWPWPPPPPPPPPWPPPPPWPWPWPPPWPPPPPWPWPPPWPWPPPPPWPPPWPPPPPW
WPWWWWWPWPWPWWWWWWWPWWWPWPWPWPWPWWWWWWWPWPWPWWWWWPWWWWWPWWWPWPWWWWWPWPWWWPWPWWWPWPWPWPWWWPWPWPWPWPWPWWWWWPWPWWWPWPWWWWWWWWWWWPWPWWWPWPWPWPWWWWWWWWWWWPW
WPPPPPWPPPWPPPWPPPWPWPPPPPWPWPPPWPPPPPPPWPWPWPPPWPPPWPWPPPWPWPPPPPPPWPPPWPWPPPWPWPPPWPWPPPWPWPWPWPWPWPPPPPWPWPPPWPWPPPPPPPWPPPWPPPWPPPWPWPPPPPWPPPPPPPW
WWWWWPWWWWWWWPWPWPWPWPWWWWWPWWWWWWWWWWWWWPWPWPWWWWWPWPWWWPWPWWWWWWWWWWWPWPWPWPWPWWWWWPWPWWWPWWWPWPWPWWWWWWWWWPWWWPWPWWWWWPWPWWWWWPWPWWWPWWWWWPWPWWWWWWW
WPPPWPWPPPPPWPPPWPWPWPWPPPPPWPPPPPPPWPPPWPPPWPPPWPWPPPPPWPPPWPPPWPPPPPWPPPWPWPWPPPWPPPWPWPPPPPWPWPWPWPPPWPPPPPWPPPWPWPPPPPWPWPPPWPWPPPPPWPPPPPWPPPPPWPW
WPWPWPWPWWWPWWWWWPWPWWWPWPWWWWWWWWWPWPWWWWWWWWWPWPWWWWWPWPWWWWWPWPWWWWWWWWWPWPWWWWWPWWWPWWWPWPWPWWWPWPWPWPWWWWWPWWWPWPWWWWWPWPWPWPWWWWWWWPWWWWWPWWWPWPW
WPWPWPWPPPWPWPPPWPWPPPPPWPWPPPWPPPPPWPPPPPPPWPPPPPWPPPWPPPWPPPWPPPPPWPPPPPWPWPPPPPWPWPPPWPPPWPPPWPPPWPWPPPWPPPWPWPPPWPPPPPWPWPWPPPWPPPPPWPWPPPWPPPWPWPW
WPWPWPWWWPWWWPWPWPWWWWWWWPWPWPWPWWWWWWWWWWWPWPWPWPWPWPWWWWWWWPWWWWWPWPWWWPWWWWWWWPWPWPWWWPWWWWWWWPWWWPWWWWWPWWWPWPWWWPWWWPWPWWWWWWWPWWWPWPWPWPWWWWWPWPW
WPWPWPWPPPPPPPWPPPWPPPPPWPWPWPPPWPPPWPWPPPWPPPWPWPPPWPPPWPPPWPPPWPPPWPWPWPWPPPPPPPWPWPPPWPPPWPPPWPPPPPWPPPWPPPPPWPWPPPPPWPWPPPWPPPPPWPPPWPWPWPPPWPPPPPW
WPWPWPWWWPWWWWWWWWWPWWWWWPWPWWWWWPWPWPWPWPWWWWWWWWWWWWWPWPWPWWWPWWWPWPWPWPWPWWWWWWWPWWWPWWWPWPWWWPWWWWWPWWWWWPWWWPWPWWWPWPWWWPWWWWWWWPWWWWWPWWWPWPWWWWW
WPWPPPPPPPPPPPPPPPWPPPPPPPPPWPPPWPWPWPWPWPPPPPPPPPPPPPWPPPWPPPWPPPWPPPWPPPPPWPPPPPPPWPPPWPPPPPPPWPPPPPPPWPPPPPWPPPWPPPWPWPWPPPWPPPPPWPPPPPWPPPWPWPPPPPW
WPWWWWWWWWWWWWWWWPWPWWWWWPWWWPWPWWWPWPWPWWWWWPWWWWWWWPWPWWWWWPWWWPWPWWWWWPWWWPWWWWWWWPWWWWWWWWWPWWWPWWWWWPWWWWWWWWWWWPWPWWWPWWWPWWWPWPWWWPWWWPWPWWWPWPW
WPWPPPPPWPPPPPPPPPWPPPPPWPWPPPWPPPPPWPPPWPPPPPPPWPPPWPWPWPWPPPWPPPWPWPPPWPPPPPWPPPPPPPWPPPPPPPWPPPPPWPPPWPPPPPPPPPPPPPWPPPWPWPWPPPWPPPWPWPWPPPWPWPPPWPW
WWWPWWWPWPWWWWWWWWWWWWWPWPWPWWWWWWWWWWWWWPWWWWWPWWWPWPWPWPWPWWWPWWWWWPWPWWWWWWWPWWWWWWWPWWWWWPWWWPWWWWWPWWWWWPWWWWWWWWWWWPWPWPWWWPWWWWWPWPWWWWWPWPWWWPW
WPPPWPPPWPPPPPWPPPWPPPWPWPPPWPPPPPWPPPPPPPWPPPWPPPPPWPPPPPWPPPWPWPWPPPWPPPPPWPPPPPWPPPPPWPPPWPPPPPWPPPPPPPPPWPPPPPWPPPWPPPWPPPPPPPWPPPPPWPPPWPWPPPWPPPW
WPWWWWWPWWWWWPWPWPWWWPWPWPWWWPWWWPWPWWWWWWWPWPWPWPWWWPWWWWWWWPWPWPWPWWWWWPWPWWWWWPWPWWWWWPWPWWWWWWWPWWWWWWWWWWWWWPWPWWWPWWWWWPWWWWWPWWWWWWWPWPWWWWWPWPW
WPWPPPPPWPPPPPWPWPPPWPWPWPWPPPWPPPWPPPPPWPPPWPWPWPPPWPPPWPPPPPWPWPPPWPPPPPWPPPPPPPWPPPWPPPWPWPPPWPWPWPPPPPPPWPPPPPWPPPPPPPPPWPPPPPWPPPPPPPPPWPPPPPWPWPW
WPWPWWWWWWWWWPWPWWWPWPWPWWWPWWWPWWWWWWWWWPWWWPWWWWWPWPWPWPWWWWWPWPWWWWWWWWWWWWWWWWWWWPWPWWWPWPWPWPWPWWWPWWWPWWWPWWWPWWWWWWWPWPWWWWWPWWWWWPWWWPWWWPWPWPW
WPWPPPPPPPPPPPWPWPPPWPPPPPPPWPPPWPWPPPPPWPPPWPWPPPWPWPWPWPPPPPPPWPWPPPPPPPPPPPPPWPPPPPWPPPWPWPWPWPPPPPPPWPWPWPPPWPPPPPPPWPWPPPWPPPWPPPPPWPPPPPPPWPPPWPW
WPWWWWWWWWWWWWWPWWWWWWWWWWWWWPWPWPWPWWWPWWWPWWWPWPWPWPWPWWWWWWWWWPWPWWWWWWWWWWWPWPWWWWWWWPWPWWWPWWWPWWWWWPWPWPWWWWWWWWWPWPWWWWWPWPWWWWWWWWWWWWWWWWWWWWW
WPPPPPPPPPPPPPWPPPPPPPWPPPPPPPWPWPPPWPWPPPWPWPPPWPPPWPWPPPWPWPPPWPWPPPWPPPPPPPPPWPWPPPPPPPWPPPPPWPPPWPPPPPWPPPWPPPPPWPWPWPPPWPPPWPPPWPPPPPPPPPPPPPPPPPW
WWWWWWWWWWWWWPWWWPWWWPWPWWWWWWWWWWWWWPWWWPWPWPWWWWWWWPWPWPWPWPWPWPWWWPWPWWWWWWWWWPWPWWWWWWWWWWWPWPWWWPWWWPWWWWWPWWWPWPWPWWWPWPWWWWWPWPWWWWWWWWWWWPWWWPW
WPPPPPPPWPPPPPPPWPWPWPWPPPWPWPPPPPPPPPWPPPWPPPWPPPPPPPWPWPWPPPWPWPPPPPWPWPPPPPWPWPWPPPPPPPPPPPWPWPPPWPPPWPWPPPPPWPPPWPPPPPWPWPWPPPPPWPWPPPWPPPWPWPPPWPW
WPWWWWWPWPWWWWWWWPWPWPWWWPWPWPWWWWWPWWWWWPWWWWWWWWWWWWWWWPWWWWWPWWWWWWWPWPWWWPWPWPWWWWWWWWWWWPWWWWWPWWWWWPWPWWWWWPWWWWWWWPWPWPWPWWWWWPWWWPWPWPWPWWWPWWW
WPPPPPWPWPPPWPPPWPPPWPPPWPPPWPWPPPWPPPPPWPPPPPWPPPPPPPPPPPWPPPPPWPWPPPPPWPWPPPWPWPWPWPPPPPPPPPWPPPWPPPWPPPWPWPPPPPWPPPPPWPPPWPWPPPWPPPPPPPWPWPWPPPWPPPW
WWWWWPWPWPWPWWWPWWWWWPWPWWWWWPWPWPWWWWWPWWWWWPWPWWWWWWWWWWWPWPWWWPWPWWWWWWWPWWWPWPWPWPWWWWWWWPWPWPWWWPWPWWWPWWWWWWWPWWWPWWWWWPWPWPWWWWWWWWWPWPWWWPWWWPW
WPPPPPWPPPWPPPWPWPPPPPWPPPPPPPWPWPPPPPPPPPPPWPPPWPPPPPWPPPWPWPPPWPPPWPPPPPPPWPPPPPPPPPWPPPPPWPWPWPPPWPWPPPWPPPPPPPPPWPPPWPPPPPWPWPPPWPPPPPWPWPPPWPPPWPW
WWWPWPWWWWWWWPWPWWWWWWWWWWWWWWWPWWWWWWWWWWWPWWWPWPWWWPWPWPWPWWWPWWWWWPWPWWWWWPWWWPWWWWWPWWWWWPWPWWWWWPWPWPWWWWWPWWWWWPWWWPWWWWWPWWWPWPWWWPWWWPWWWWWPWPW
WPPPWPPPWPPPWPWPPPPPPPPPPPPPPPWPPPPPPPWPPPPPWPPPWPWPPPWPWPWPPPWPWPPPWPWPPPWPPPWPPPWPPPWPWPPPPPWPPPWPPPWPWPWPPPWPWPPPPPWPPPWPPPWPWPWPPPWPPPPPPPWPPPPPPPW
WPWWWWWWWPWPWPWWWWWWWPWPWPWWWPWWWWWWWPWPWWWWWPWWWPWPWWWWWPWWWPWPWWWPWWWWWPWWWWWPWWWPWPWPWPWWWWWWWPWPWWWPWPWPWPWPWPWWWWWPWWWPWPWPWPWWWWWPWWWWWWWPWWWWWWW
WPPPWPPPPPWPWPPPPPPPWPWPWPWPPPPPWPPPWPWPPPPPWPPPWPWPPPPPWPWPPPWPPPPPWPPPWPPPPPPPWPPPWPPPWPWPPPWPWPPPWPWPWPPPWPWPWPWPPPWPWPPPWPPPPPWPPPWPWPPPPPPPWPPPWPW
WWWPWPWWWWWPWWWWWWWPWWWPWPWPWWWWWPWPWPWWWWWPWWWPWPWWWWWPWPWWWPWWWPWPWPWPWWWWWWWWWPWWWWWWWPWPWPWPWPWWWPWPWWWPWPWPWPWPWPWPWPWWWWWWWWWPWPWWWPWWWWWWWPWPWPW
WPWPWPPPPPWPWPWPPPPPWPPPWPWPPPPPWPWPPPWPPPPPWPWPWPPPPPWPWPPPWPPPWPWPPPWPWPPPPPPPWPPPPPPPWPPPWPPPWPPPWPPPWPPPWPWPWPWPWPWPWPPPWPPPPPWPWPWPPPWPPPPPPPWPWPW
WPWPWPWWWPWPWPWPWWWWWPWWWPWWWWWPWPWWWWWPWWWWWPWPWWWWWPWPWWWPWWWPWWWWWWWWWPWWWWWPWWWWWPWWWWWPWWWWWWWPWWWWWWWWWPWPWPWWWPWPWWWPWPWPWPWPWPWPWWWPWWWWWWWPWPW
WPPPWPWPPPWPWPWPPPPPWPPPWPPPWPPPWPWPWPPPWPPPWPWPPPWPPPWPPPWPPPWPPPWPPPPPPPWPPPWPWPWPPPPPWPPPWPPPWPPPWPPPPPWPPPWPWPPPPPWPWPWPPPWPWPWPWPPPWPPPWPPPPPPPPPW
WPWWWPWPWWWPWPWWWPWPWWWPWWWPWPWWWPWPWPWWWWWPWPWWWPWPWWWWWPWPWWWWWPWPWWWWWWWPWPWPWPWPWPWPWPWWWWWPWPWWWPWWWPWWWPWPWWWWWWWPWPWWWWWPWPWWWPWWWPWWWPWWWWWWWWW
WPWPPPWPWPWPWPPPPPWPPPWPWPPPWPPPPPWPWPWPPPWPPPPPPPWPPPPPWPPPPPPPPPWPPPPPPPPPWPWPPPWPWPWPWPPPWPPPWPWPWPPPWPWPPPWPPPWPPPPPWPWPPPWPWPPPPPPPWPWPPPWPPPWPPPW
WWWPWWWPWPWPWWWWWWWWWPWWWPWWWWWPWPWPWPWPWPWWWPWWWWWWWPWPWWWWWWWWWPWWWWWWWWWWWWWWWPWPWPWPWWWPWPWWWPWPWWWPWPWPWPWWWPWPWPWWWPWWWPWWWWWWWPWPWPWPWWWPWPWWWPW
WPPPWPWPWPPPWPPPPPPPWPPPPPWPPPPPWPPPWPPPWPWPPPWPPPWPWPWPPPPPWPPPWPPPWPPPPPWPPPWPPPPPWPWPWPPPWPPPPPWPPPWPWPWPWPPPWPPPWPPPPPWPPPWPPPWPPPWPPPWPPPWPWPPPPPW
WPWWWPWPWWWPWPWWWWWPWPWWWWWPWWWWWWWWWWWWWPWPWWWPWPWPWPWWWWWPWPWPWWWWWPWWWPWPWPWPWPWPWPWWWPWWWWWWWWWWWPWPWPWWWWWPWWWWWPWPWWWPWWWPWPWPWWWWWWWWWPWPWWWWWWW
WPPPPPWPPPWPWPWPPPWPWPWPPPPPWPPPWPPPWPPPPPWPWPPPWPWPPPWPPPPPWPWPPPPPWPPPWPPPWPWPWPWPWPPPPPWPWPPPWPPPWPPPWPPPPPWPWPPPPPWPPPWPPPPPWPPPWPPPWPPPPPWPPPPPWPW
WWWPWWWWWPWPWPWPWWWPWPWPWWWWWPWPWWWPWPWWWWWPWPWWWPWPWWWWWPWWWPWWWWWPWWWPWWWWWPWPWPWPWWWWWWWPWPWPWPWPWWWWWWWWWPWPWPWWWWWWWPWPWWWWWWWWWWWPWPWWWWWWWWWPWPW
WPWPWPWPPPWPWPWPPPWPPPWPWPPPWPWPWPPPPPWPPPWPWPWPPPWPWPPPWPPPWPWPPPPPWPPPWPPPWPWPWPWPPPPPPPPPWPWPWPWPPPPPWPPPWPPPWPPPPPWPWPWPPPPPWPPPWPPPWPWPPPPPPPPPWPW
WPWPWPWPWWWWWPWWWPWWWWWPWPWPWPWPWPWWWWWPWPWPWPWPWWWPWPWPWWWWWPWPWWWWWPWWWPWWWPWWWPWWWWWWWWWPWPWPWPWWWWWPWPWPWPWWWPWWWPWPWPWPWWWPWPWWWPWPWPWWWPWWWWWWWPW
WPPPWPPPPPPPPPPPWPWPPPWPWPWPWPWPWPPPWPPPWPPPWPWPPPWPWPWPPPWPPPWPWPWPPPWPWPPPPPWPPPWPPPWPPPPPWPWPPPWPPPWPPPWPWPWPPPWPPPWPPPWPWPPPWPWPPPWPWPPPPPPPPPPPWPW
WPWWWWWWWWWWWWWWWPWPWPWPWPWPWPWWWWWPWPWWWWWWWPWWWPWPWWWWWPWPWWWPWPWPWWWPWWWWWWWPWWWPWPWPWPWWWWWWWPWPWPWWWWWPWPWPWWWPWWWWWWWPWWWWWPWPWWWPWWWWWPWWWWWPWPW
WPWPPPWPPPPPWPPPPPWPWPWPPPWPWPWPPPWPWPWPPPWPPPWPPPWPPPPPPPWPPPWPPPPPWPWPWPPPWPPPWPPPWPPPWPPPPPPPPPWPWPPPPPWPWPPPWPPPWPPPPPPPWPPPWPPPWPPPWPPPPPWPPPWPPPW
WPWPWPWPWWWPWPWWWWWWWPWWWPWPWPWPWWWPWPWPWPWPWWWPWWWPWWWWWWWWWPWWWWWWWPWPWWWPWPWWWPWWWWWWWWWWWWWWWWWPWWWWWPWPWPWWWPWWWPWWWWWWWPWPWWWWWPWWWPWWWWWPWPWPWWW
WPWPWPPPWPPPWPPPPPPPPPWPPPWPPPWPPPPPWPPPWPWPPPWPPPPPPPPPPPPPPPWPPPPPPPWPPPWPWPWPPPWPPPWPPPPPWPPPWPPPWPPPWPPPWPWPWPPPWPPPWPPPPPWPPPPPPPWPPPWPPPPPWPWPPPW
WWWPWWWWWWWWWWWWWWWWWPWPWPWWWWWWWWWWWWWWWPWWWPWWWWWPWWWWWWWWWWWPWWWPWWWWWPWPWPWPWWWWWPWPWWWPWWWPWPWWWPWPWWWWWPWPWWWPWWWPWPWWWPWWWWWWWWWPWPWPWWWWWPWWWPW
WPPPWPPPWPPPWPPPPPWPWPPPWPPPWPPPPPPPWPPPWPPPWPPPWPPPWPPPPPWPPPWPPPWPPPPPWPPPWPWPPPWPPPWPPPWPPPPPWPPPPPWPPPPPWPWPWPPPWPPPWPPPWPPPWPPPWPPPWPWPPPPPWPPPPPW
WPWPWWWPWPWPWPWWWPWPWWWWWWWPWPWWWWWWWPWPWPWPWWWPWPWWWPWPWPWPWPWWWPWWWWWPWWWPWPWWWPWPWWWWWPWWWWWWWWWWWWWWWWWPWPWPWPWWWWWWWPWPWWWPWPWWWPWWWPWWWWWPWWWWWWW
WPWPPPWPPPWPWPWPPPWPWPPPWPPPWPWPPPWPPPWPPPWPPPPPWPWPPPWPWPPPWPPPWPPPPPWPWPPPPPWPPPWPPPPPPPWPPPPPPPWPPPWPPPPPWPWPWPWPPPPPWPWPWPWPWPPPPPWPWPPPWPWPPPPPWPW
WPWWWPWWWPWPWPWPWWWPWWWPWPWWWPWPWPWPWWWWWWWWWWWWWPWWWWWPWWWWWWWPWWWWWPWPWWWPWWWPWWWWWPWWWWWWWWWPWPWWWPWWWPWPWPWPWPWPWWWPWWWPWPWPWWWWWWWPWPWPWPWWWWWPWPW
WPPPWPPPPPWPWPWPPPPPWPPPWPWPPPPPWPWPWPPPPPWPPPPPWPWPPPPPWPPPPPPPPPPPWPWPPPPPWPPPWPPPPPWPPPWPPPPPWPPPPPWPPPWPWPWPPPWPWPPPWPPPWPWPWPPPPPWPWPWPPPWPPPWPWPW
WWWPWWWWWWWPWPWWWWWWWPWWWPWPWPWWWWWPWWWPWWWPWWWPWPWPWWWWWWWWWWWWWWWPWPWWWWWPWPWWWPWWWWWPWPWPWWWWWWWWWWWPWWWWWPWWWWWPWWWWWPWWWPWPWPWWWPWPWPWWWWWPWPWPWPW
WPPPWPPPPPWPWPPPPPWPPPPPWPPPWPWPPPPPWPPPWPPPPPWPWPPPWPPPPPPPPPPPPPPPWPWPPPPPWPWPPPWPPPPPWPWPPPWPPPPPPPWPPPPPWPWPPPWPPPWPPPPPWPWPWPPPWPWPPPWPPPPPWPWPPPW
WPWWWWWWWPWPWPWWWPWPWWWPWWWWWPWPWWWWWPWWWPWWWPWPWWWWWPWPWWWWWWWWWWWWWPWPWWWWWPWPWWWPWPWWWPWPWPWWWPWWWWWWWWWPWPWPWPWWWPWPWPWPWPWPWWWPWPWWWWWWWPWWWPWPWWW
WPWPPPWPWPWPWPWPWPWPWPPPWPPPWPPPWPPPWPWPWPPPWPWPWPPPPPWPPPWPPPPPPPPPPPWPPPPPWPPPWPPPWPWPWPPPWPPPPPWPWPPPWPPPWPWPWPPPPPWPWPWPWPWPPPWPWPWPPPWPPPPPWPWPPPW
WPWPWPWPWPWPWPWPWPWPWPWPWPWPWWWPWPWPWPWPWWWPWPWPWPWWWWWWWPWPWWWWWWWPWWWWWPWPWWWWWWWWWPWPWWWWWWWWWWWPWPWWWPWWWPWPWWWWWWWPWPWWWPWWWPWWWPWPWWWPWWWWWPWWWPW
WPPPWPPPWPWPPPWPPPPPWPWPPPWPPPWPPPWPPPWPPPWPWPWPWPWPPPWPWPPPWPPPWPPPWPPPPPWPPPWPPPWPPPWPWPPPPPPPWPPPWPPPWPWPPPWPPPPPWPWPWPPPWPPPPPWPPPWPPPPPPPPPWPPPWPW
WWWWWWWPWPWWWWWWWWWWWWWWWWWWWPWWWWWWWPWWWPWPWPWPWPWPWPWPWWWWWPWPWWWPWPWWWWWPWPWPWPWPWWWPWPWPWWWPWPWWWWWPWPWPWWWWWPWPWPWPWWWPWWWWWWWPWWWWWWWWWPWPWWWWWPW
WPPPWPPPWPWPPPPPPPPPPPWPPPPPWPPPPPPPPPWPWPPPWPWPWPPPWPWPPPPPPPWPPPWPWPWPPPWPWPPPWPPPWPPPWPWPPPWPPPPPPPWPWPPPWPPPPPWPWPPPPPWPPPWPPPWPPPWPPPWPPPWPPPPPPPW
WPWPWPWWWPWPWWWWWWWWWPWPWWWPWWWPWWWWWWWPWWWWWPWPWPWWWPWWWWWWWWWWWPWWWPWPWPWWWWWWWWWWWPWPWPWWWWWWWWWWWPWPWPWWWWWWWWWPWWWWWWWPWPWPWPWWWPWPWPWPWWWWWWWWWWW
WPWPPPPPWPWPPPWPPPPPWPPPWPWPPPPPPPPPPPPPWPPPWPWPPPWPWPWPPPPPPPPPPPWPPPWPWPPPPPPPPPPPPPWPWPWPPPWPPPWPPPWPPPPPPPPPPPWPPPWPPPWPWPWPWPWPPPWPWPWPPPPPPPPPPPW
WPWWWWWWWPWWWPWPWPWPWWWWWPWWWWWWWWWWWWWWWPWPWPWWWWWPWPWPWWWWWWWWWWWPWWWPWWWWWWWPWWWWWWWWWPWPWPWPWPWPWWWWWWWWWWWPWWWWWPWPWPWPWWWPWPWPWWWWWPWWWWWWWWWWWPW
WPWPPPWPPPWPPPWPWPWPPPWPWPPPPPPPPPPPPPWPWPWPPPWPPPPPWPPPWPWPPPPPWPWPWPPPWPWPPPPPWPPPWPPPWPPPWPWPWPWPWPPPWPPPPPPPPPPPPPWPWPWPPPPPWPWPPPPPWPWPPPPPPPPPWPW
WPWPWPWPWWWPWWWPWWWWWPWPWWWWWWWPWWWWWPWPWPWWWWWPWWWWWWWWWPWPWWWPWPWPWPWWWPWPWWWWWPWWWPWPWWWWWPWWWPWPWPWPWPWWWWWPWWWWWWWPWPWPWWWWWPWWWWWPWPWPWWWWWWWPWPW
WPWPWPPPWPPPWPWPWPPPWPPPPPPPPPWPWPPPWPPPPPWPPPWPPPPPWPPPWPWPPPWPPPWPWPPPPPWPPPPPWPPPPPWPPPWPWPPPWPPPPPWPPPWPPPWPPPWPPPPPWPWPPPPPWPWPPPPPWPPPWPPPPPWPWPW
WPWPWWWWWPWWWPWPWPWPWWWWWWWPWWWPWPWPWWWWWWWPWWWWWWWPWPWPWPWWWPWWWWWPWWWWWWWWWWWPWWWWWWWWWPWPWWWPWWWWWWWWWWWPWPWWWPWWWWWWWPWPWWWPWPWPWPWWWWWWWPWWWPWPWPW
WPWPWPPPWPWPPPWPPPWPWPPPPPWPPPWPPPWPPPPPPPWPPPPPPPWPPPWPWPPPWPPPPPWPPPPPWPPPWPPPWPPPPPPPWPPPPPPPWPPPPPWPPPPPWPPPWPWPPPPPPPWPWPPPWPWPWPPPWPPPWPPPWPWPWPW
WPWPWWWPWPWPWWWWWWWPWPWWWPWWWPWWWPWWWWWWWPWPWWWWWPWWWWWPWWWPWWWWWPWWWWWPWPWPWPWWWPWWWWWPWWWPWWWWWPWWWPWWWWWWWPWWWPWPWWWWWWWPWPWWWWWPWWWWWPWPWPWPWPWPWPW
WPPPWPPPWPWPWPPPPPPPWPWPPPWPWPWPWPPPPPWPPPWPWPWPPPWPPPPPPPPPPPWPPPPPWPPPWPWPWPWPWPPPWPWPPPPPWPPPPPPPWPPPWPPPWPPPPPWPWPPPPPPPWPWPWPPPWPPPWPWPPPWPWPPPPPW
WWWPWPWWWPWPWPWWWWWWWWWPWPWPWPWPWWWWWPWPWWWPWPWPWWWPWWWWWWWWWPWPWPWWWPWWWWWPWPWPWWWPWPWWWWWWWPWWWWWWWWWPWPWPWPWWWWWPWPWWWWWWWPWPWPWWWPWPWPWWWWWWWWWPWWW
WPPPWPPPPPWPWPPPPPWPPPPPWPWPWPWPWPPPPPWPPPWPPPWPPPPPWPPPPPWPWPPPWPPPPPWPPPPPWPWPPPWPWPPPPPPPWPWPPPPPWPWPWPWPWPPPPPPPPPWPPPPPPPWPWPPPPPWPWPPPPPPPWPPPPPW
WPWWWWWWWWWPWWWWWPWPWWWWWWWPWPWPWPWPWWWPWWWWWPWWWWWPWPWWWPWPWWWPWWWWWWWPWWWPWPWPWPWPWWWWWWWPWPWWWWWPWPWPWPWPWWWWWWWPWWWPWWWWWWWPWWWWWWWPWWWWWWWPWPWWWWW
WPWPPPWPPPPPPPWPPPWPWPPPPPPPWPWPWPWPWPWPPPPPWPPPWPPPWPWPPPWPWPWPPPWPPPWPWPPPWPWPWPWPPPPPPPWPPPWPPPPPWPPPPPWPPPWPPPPPWPPPWPPPPPPPWPPPPPWPWPWPPPPPWPWPPPW
WPWWWPWPWWWWWWWPWWWPWPWPWWWWWPWPWWWPWPWWWPWWWWWWWPWWWPWPWWWPWPWPWPWPWPWPWWWWWPWPWPWWWWWWWPWWWWWPWWWWWWWWWWWWWPWPWWWWWPWPWPWWWWWWWPWPWPWPWPWPWPWWWPWWWPW
WPWPPPWPPPPPPPWPPPWPWPWPPPPPWPWPWPPPWPWPWPPPWPPPPPWPPPWPPPPPWPWPWPWPWPPPWPPPWPPPWPWPPPPPPPWPPPWPPPWPPPPPPPPPWPWPPPWPPPWPWPPPWPPPWPWPWPWPPPPPWPPPWPPPPPW
WPWPWWWWWPWWWPWWWPWPWPWWWWWWWPWPWPWWWPWPWWWPWWWPWWWPWWWWWWWWWPWWWPWPWWWWWPWPWWWPWPWPWWWPWWWPWPWPWPWPWPWPWWWPWPWWWPWWWWWWWWWPWWWPWWWPWPWPWWWWWWWPWWWWWWW
WPPPPPWPPPWPPPWPPPPPWPPPPPPPWPWPWPPPWPWPPPPPWPPPWPPPWPPPPPPPWPPPPPWPPPPPPPWPWPPPWPWPWPPPWPWPWPWPWPWPWPWPPPWPPPWPWPWPPPPPWPWPPPWPWPPPWPPPWPPPPPWPPPPPPPW
WWWWWPWPWWWPWWWPWPWWWWWWWWWPWPWPWPWPWPWWWWWPWPWWWPWWWPWWWWWPWWWWWWWWWWWWWWWPWWWWWPWPWPWWWPWPWPWPWPWPWPWWWPWWWWWPWPWPWWWPWPWWWPWPWPWWWWWWWPWWWPWWWWWWWPW
WPWPPPWPPPWPWPPPWPPPPPPPPPWPWPWPWPWPPPWPPPWPWPWPWPPPWPPPPPWPWPPPPPPPPPPPPPWPPPWPPPWPWPWPPPPPWPPPWPPPWPPPWPPPPPPPWPPPWPPPWPPPWPPPPPWPPPPPWPPPWPPPPPPPWPW
WPWPWWWWWWWPWWWWWWWWWWWWWWWPWPWPWPWWWWWPWPWPWPWPWWWPWWWWWPWWWPWPWWWWWPWWWPWWWPWWWPWPWPWPWWWWWWWWWPWWWWWWWWWWWWWWWWWWWPWWWPWWWWWWWWWWWPWPWPWPWWWWWWWWWPW
WPPPWPPPWPPPWPPPPPWPWPPPPPWPWPWPPPWPPPPPWPPPWPWPPPWPWPPPPPPPPPWPWPPPWPPPWPWPWPWPPPPPWPPPWPPPWPPPPPWPPPPPPPPPPPWPPPPPWPPPPPPPWPPPWPPPWPWPWPWPPPPPPPPPPPW
WWWWWPWPWPWWWPWWWPWPWPWWWPWPWPWWWWWPWPWWWWWWWPWWWPWPWPWWWWWWWWWPWPWWWWWWWPWPWPWPWPWWWWWWWPWWWPWWWWWPWWWWWWWWWPWWWWWPWWWWWPWPWPWPWPWPWPWPWWWWWWWWWWWWWPW
WPWPPPWPWPPPWPWPWPPPWPPPWPPPWPPPPPPPWPWPPPWPWPPPPPWPWPWPPPPPPPPPWPPPWPPPPPWPWPPPWPPPPPWPWPPPPPWPPPWPWPPPWPPPPPPPPPWPWPPPWPWPPPWPPPWPWPWPWPPPWPPPPPPPPPW
WPWPWWWPWWWPWPWPWWWPWWWWWPWWWWWWWWWWWPWPWPWPWWWWWPWPWWWPWWWWWWWWWWWPWWWPWWWPWWWWWWWPWPWPWWWWWWWPWPWPWPWPWWWWWPWWWPWPWPWPWPWWWWWPWWWPWPWWWPWPWWWWWWWWWPW
WPPPWPWPPPWPPPWPPPPPPPWPPPPPWPPPPPPPPPWPWPPPWPWPPPPPWPPPWPPPWPPPPPWPPPPPPPPPWPPPWPPPWPWPPPPPPPPPWPPPWPWPPPPPWPWPPPWPPPWPPPWPPPWPWPPPWPPPPPWPPPPPWPPPWPW
WWWWWPWWWPWWWWWPWWWWWPWPWPWPWPWWWWWWWWWPWWWPWPWPWPWWWPWWWPWPWPWWWPWWWWWPWWWWWWWPWPWWWPWWWWWWWWWWWWWWWPWPWWWPWWWPWWWPWWWWWWWPWPWWWPWWWWWWWWWWWWWPWPWPWPW
WPPPWPPPWPWPWPPPWPWPPPWPWPWPPPWPPPWPWPPPWPWPWPPPWPPPWPWPPPWPWPPPWPPPWPWPPPWPPPPPPPWPPPPPPPPPPPPPWPPPPPWPWPWPPPWPPPPPWPPPWPPPWPWPPPWPPPWPPPWPPPWPPPWPPPW
WPWPWPWPWPWPWPWWWPWPWWWPWWWWWWWPWPWPWPWWWPWPWWWWWWWPWPWPWWWPWWWPWWWPWPWWWPWPWWWWWWWPWWWWWWWWWWWPWPWWWWWPWPWWWPWWWWWWWPWPWPWWWWWPWWWPWPWWWPWPWWWWWWWWWPW
WPWPWPWPWPPPPPWPWPWPPPPPWPPPWPPPWPPPWPPPPPWPPPPPWPPPWPWPPPWPPPWPWPWPWPWPWPWPPPWPPPWPWPPPWPPPPPPPWPPPWPWPPPWPPPWPPPPPWPWPPPWPPPWPPPWPWPPPPPWPPPPPPPPPWPW
WPWPWPWPWWWPWWWPWPWWWWWWWPWPWPWWWWWWWWWWWWWWWWWPWPWWWPWPWPWWWPWPWPWPWPWPWPWPWWWPWPWPWWWPWPWPWWWWWWWPWPWPWWWPWPWWWWWPWPWWWWWPWPWWWPWPWWWWWWWWWWWPWWWPWPW
WPWPWPWPWPPPWPPPWPWPPPPPPPWPPPWPPPPPPPPPPPPPPPWPPPPPWPPPWPPPWPWPWPPPWPPPPPWPPPPPWPWPPPPPWPWPPPPPWPPPWPPPWPPPWPPPPPPPWPPPPPPPWPPPPPWPPPWPPPWPPPWPPPWPWPW
WPWPWPWPWWWWWPWWWPWPWWWWWWWWWPWPWWWWWWWWWPWPWWWWWWWPWWWWWWWPWPWPWWWWWWWPWPWWWWWWWPWWWWWWWWWWWWWPWPWWWWWWWPWWWPWWWWWWWWWWWPWWWWWWWWWWWPWPWPWPWPWWWPWPWWW
WPWPWPWPPPWPPPPPPPWPPPPPWPPPWPWPWPPPPPPPWPWPWPPPPPPPWPPPPPPPWPPPWPPPPPPPWPPPPPWPPPWPPPPPWPPPPPPPWPWPPPWPPPPPWPPPWPPPPPWPPPWPPPPPWPPPPPWPWPWPWPPPPPWPPPW
WWWPWPWWWPWPWPWWWWWWWWWPWPWPWPWPWPWWWWWPWWWPWPWWWWWWWPWWWPWWWWWWWPWWWWWWWPWPWPWPWWWPWWWPWPWWWWWWWPWPWPWWWWWPWWWPWPWWWWWPWWWWWPWPWPWWWWWWWPWPWWWWWWWWWPW
WPPPWPWPPPWPWPPPPPPPPPPPWPWPWPPPWPWPPPPPWPPPWPPPWPWPPPWPPPWPPPWPPPWPPPPPWPWPWPWPWPPPWPPPWPPPWPPPPPWPWPPPPPPPWPPPWPPPPPWPWPPPWPWPWPWPPPPPWPWPPPPPWPWPPPW
WPWWWPWWWWWWWWWWWWWPWWWWWWWPWWWWWPWPWWWWWPWWWWWPWPWPWWWPWWWPWPWPWWWPWWWPWPWPWWWPWPWWWWWWWPWPWPWWWWWWWWWWWWWWWPWPWWWWWPWPWPWPWPWPWPWPWWWPWPWWWWWPWPWPWWW
WPPPWPPPWPPPPPWPPPWPWPPPPPPPWPPPPPWPWPPPPPPPPPPPWPPPWPWPPPWPWPPPWPPPWPWPPPWPPPPPWPPPWPPPPPWPWPPPPPPPWPPPPPPPPPWPWPPPWPPPWPWPPPWPPPWPPPWPWPWPPPWPWPPPPPW
WPWWWWWPWPWWWPWPWWWPWPWWWWWWWPWWWWWPWPWWWPWWWWWWWWWWWPWPWPWPWWWWWPWWWPWWWWWWWWWWWWWPWPWWWWWPWWWWWWWPWWWWWWWWWWWPWPWPWWWWWPWWWWWWWWWWWPWPWPWWWPWPWWWWWPW
WPPPPPPPWPPPWPWPPPPPWPWPPPPPWPPPWPWPWPPPWPPPWPPPPPWPPPWPWPWPPPWPPPWPPPWPPPWPPPPPPPWPPPWPPPWPPPPPPPWPPPPPPPPPPPWPPPWPWPPPWPPPPPPPWPPPWPWPWPPPPPWPPPPPWPW
WWWWWWWPWWWPWPWWWPWWWPWPWWWWWWWPWPWPWWWPWWWPWPWWWPWPWWWPWWWWWPWPWWWPWPWWWPWPWWWPWPWWWWWPWPWWWWWWWPWWWWWPWWWWWPWWWPWPWPWPWWWWWWWPWPWPWPWPWWWWWPWPWWWPWWW
WPPPPPWPPPPPWPPPWPPPWPPPWPPPPPWPPPWPPPPPWPWPPPWPPPWPWPPPWPPPPPWPPPWPWPWPPPWPPPWPWPPPWPPPWPWPWPPPPPWPPPPPPPPPWPWPPPWPPPWPWPPPWPPPWPWPWPWPPPWPPPPPPPWPPPW
WPWWWPWWWWWPWWWPWWWPWWWPWPWWWPWPWWWWWWWWWPWWWWWPWPWPWPWWWPWWWWWWWPWPWPWPWWWPWPWPWWWPWPWWWPWPWPWWWWWPWWWWWWWPWPWPWWWWWWWPWPWPWPWPWPWPWPWWWPWPWPWWWWWWWPW
WPPPWPPPPPWPWPWPPPPPPPPPWPWPWPWPWPPPPPPPWPPPWPPPWPWPPPWPWPWPPPWPPPWPWPWPPPPPWPWPPPWPWPPPWPWPWPPPWPPPWPPPWPPPWPWPWPPPPPWPPPWPPPWPPPWPWPPPWPPPWPPPPPWPPPW
WWWPWWWWWWWPWPWWWWWPWWWWWPWPWPWWWPWWWWWPWWWPWPWWWPWWWWWPWPWPWWWPWWWPWPWWWWWWWPWWWPWPWWWPWPWPWPWPWPWPWPWWWPWWWPWPWPWWWPWWWWWPWWWWWWWWWWWPWWWWWWWWWPWPWWW
WPPPPPPPPPPPWPPPPPPPPPPPPPPPWPPPPPWPPPPPWPPPPPWPPPWPPPPPPPWPPPPPPPPPWPPPPPPPPPWPPPWPPPPPWPPPWPWPPPWPWPPPPPWPPPWPPPPPWPPPPPWPPPPPPPPPPPPPWPPPPPPPPPWPPPF
WWWWWWWWWWWWWWWWWWWWWWWWWWWWWWWWWWWWWWWWWWWWWWWWWWWWWWWWWWWWWWWWWWWWWWWWWWWWWWWWWWWWWWWWWWWWWWWWWWWWWWWWWWWWWWWWWWWWWWWWWWWWWWWWWWWWWWWWWWWWWWWWWWWWWWW

