WWWWWWWWWWWWWWWWWWWWWWWWW
PPPPPPPPWPPPPPPPPPWPPPSPW
WPWWWWWWWPWWWWWWWPWPWWWPW
WPWPPPPPWPWPWPPPWPPPWPPPW
WPWPWWWPWPWPWPWWWWWWWPWWW
WPWPWPWPWPPPWPPPWPPPWPPPW
WPWPWPWPWWWPWWWPWPWPWPWPW
WPPPWPWPPPPPWPPPPPWPPPWPW
WWWWWPWWWWWWWPWWWWWWWWWPW
WPPPWPWPPPPPWPPPWPWPPPPPW
WPWPWPWPWPWWWWWPWPWPWWWWW
WPWPWPPPWPPPPPPPWPPPPPPPW
WPWPWWWWWWWWWWWPWWWWWWWWW
WPWPWPPPPPPPPPPPWPPPPPPPW
WPWPWPWWWWWWWWWWWPWWWWWPW
WPWPWPPPPPPPWPPPWPPPWPWPW
WPWWWWWWWWWPWPWPWPWPWPWPW
WPPPPPWPPPWPPPWPPPWPPPWPW
WWWWWPWPWPWWWWWWWWWWWWWPW
WPPPPPWPWPPPWPPPPPWPPPPPW
WPWPWPWPWWWPWWWWWPWPWWWWW
WPWPWPPPWPWPWPPPPPPPWPPPW
WPWPWWWWWPWPWPWWWWWWWWWPW
WPWPWPPPPPWPWPPPPPPPWPPPW
WWWPWPWWWPWPWWWWWWWPWPWWW
WPPPWPPPWPPPPPWPPPPPWPPPW
WPWWWWWPWWWWWWWPWWWWWWWPW
WPPPWPPPWPPPWPPPWPPPPPWPW
WWWPWWWWWPWPWPWWWPWWWPWPW
WPWPPPPPWPWPWPPPPPWPPPWPW
WPWWWWWPWPWWWPWWWPWPWWWPW
WPPPPPWPWPWPPPWPPPWPWPPPW
WPWWWWWPWPWPWWWWWWWPWPWWW
WPWPPPWPPPWPWPWPPPPPWPPPW
WPWPWPWPWPWPWPWPWPWWWWWPW
WPWPWPPPWPPPWPPPWPPPPPPPW
WPWPWWWWWWWWWWWWWWWWWPWWW
WPPPPPPPPPWPPPWPWPPPPPWPW
WWWPWPWWWPWWWPWPWPWWWWWPW
WPPPWPPPWPPPPPPPWPPPPPPPF
WWWWWWWWWWWWWWWWWWWWWWWWW

