WWPPPPPPPHPWW
WWPPHPPHPPPWW
WWHPWWWWWPHWW
WWPPWWWWWPPWW
WWPPWWWWWPPWW
WWHPWWWWWPHWW
FPHPPPPPPPPPS