SPPHPPPPPPPPPPPHPPPHPPPHPPPHPPPHPPPHPPPHPPPHPPPHPPPHPPPHPPPHPPPHPPPHPPPHPPPHPPPHPPPHPPPHPPPHPFW
WWWPWPWPWWWWWWPWWWWWWWWPWWWWPWWWWWWWWWPWWWWWWWPPPWWWWWWWWWWWWWWWWWWWPWWWWWWWWWWPWWWWWWWPWWWWPWW
WWWPWWWWWWWWWWPWWWWWWWWWWWWWPPPWWWWWPPWWWWWWWWPPPPPPPWWWWWWWWPWWWWWWPWWWWWWWWWWPWWWWWWWPWWWWWWW
PPPHPPPPHPPPPPHPPPPPPPPPPPPPPPPWWWWWWWWWPPPPPPPPPWWWWWWWWWWWWWWWWWWWPWWWWWWWWWWPWWWWWWWPWWWWWWW
PPPPPPPWWWWWWWWWWWWWWWWWWWWWWWWWWWWWWWWWWWPPPPPPPPWWWWWWWWWWWWWWPPPPPPPPPPWWWWWPWWWWWWWPPPPPPPP
PPPPPPPPWWWWWWWWWWWWWWPPPPPPPPPPPPPPPPPPPPPPPWWWWWWWWWWWWWWWWWWPPPPPPPPPPPPPPPPPPPPPPPPPWWWWWWW
PPPPPPPPWWWWWWWWWWWWWWWWWWWWPPPPPPPPPWWWWWPPPPWWWWWWWWWWWPPPPPPPPPPWWWWWPPPPPPPWWWWWPPPWWWWWPPP