WWWWWWWWWWWWWWWWWWWW
FPPPPPPPPPPPPPPPWWWW
WPPPWWWWWWWWWWWPPPPS
WWWPPPPPPPPPPPPPWWWW
WWWPWWWWWWWWWWWPWWWW
WWWPWWWWWWWWWWWPWWWW
WWWPPPHPPPPPPPHPWWWW
WWWPWWWWWWWWWWWHWWWW
WWWPPPHPPPHPPPPPWWWW